TCN75A	KEYWORD1

begin	KEYWORD2
readTemperature	KEYWORD2
setHystTemp	KEYWORD2
setLimitTemp	KEYWORD2
setRangeTemp	KEYWORD2
getLimitTemp	KEYWORD2
getHystTemp	KEYWORD2
setOneShot	KEYWORD2
setResolution	KEYWORD2
setFaultQueue	KEYWORD2
setAlertPolarity	KEYWORD2
setAlertMode	KEYWORD2
setShutdown	KEYWORD2
checkConfig	KEYWORD2

ONESHOT	LITERAL1	checkConfig	RESERVED_WORD2
ADC_RESO	LITERAL1	checkConfig	RESERVED_WORD2
F_QUEUE	LITERAL1	checkConfig	RESERVED_WORD2
ALERT_POL	LITERAL1	checkConfig	RESERVED_WORD2
COMP_INT	LITERAL1	checkConfig	RESERVED_WORD2
SHUTDOWN	LITERAL1	checkConfig	RESERVED_WORD2

COMP_MODE	LITERAL1	setAlertPolarity	RESERVED_WORD2
INT_MODE	LITERAL1	setAlertPolarity	RESERVED_WORD2